*******X*X*X*X*******X***X*********X*******X*X***X*
*X*XXXXX*X*X*X*XXXXXXX*XXX*XXXXXXXXX*XXXXX*X*XXX*X*
*X***X*X***X*********X*****X*X***X*X*****X*****X***
*X*XXX*X*XXX*XXXXXXXXX*XXX*X*XXX*X*X*XXXXXXXXX*X*X*
*X*************X***X*****X***X***X***X***X***X*X*X*
XX*X*X*XXX*X*XXX*XXX*XXX*XXXXXXX*XXX*X*XXX*XXXXXXX*
***X*X***X*X***X***X*X*****X***X*****************X*
*XXX*X*XXXXX*X*X*XXXXX*XXXXXXX*X*X*XXXXX*XXXXXXXXX*
***X*X*****X*X*********X*X*******X*X*X*****X*******
XXXXXX*X*X*XXX*X*X*XXX*X*X*XXXXXXXXX*XXXXXXX*XXXXXX
*X*****X*X***X*X*X***X*X*****X*X*X*X*X***X*X***X***
*XXX*XXX*XXX*XXX*X*XXXXXXX*X*X*X*X*X*X*XXX*X*XXXXX*
*****X*****X***X*X*X*X*X***X*****X*****X*********X*
XX*X*XXXXXXXXXXXXXXX*X*X*X*XXXXXXX*XXX*X*XXX*XXXXX*
***X*********************X***X*****X***X*X*X*X*****
XX*XXX*XXX*XXXXXXX*X*X*XXX*XXX*XXXXXXXXX*X*XXX*XXX*
*****X***X*X***X***X*X***X*X***************X*****X*
XX*XXXXX*X*X*XXXXXXX*X*XXXXX*XXX*XXX*X*XXX*X*XXXXX*
*****X***X***X*****X*X*X*******X*X*X*X*X***X***X*X*
*X*X*X*XXX*XXX*X*XXX*XXX*X*X*X*XXX*XXXXXXXXX*XXX*XX
*X*X*X***X*****X*X*X*X***X*X*X***X*****X*X*X*X*****
*XXX*XXXXX*X*XXXXX*XXX*XXX*XXXXXXX*X*XXX*X*X*X*XXXX
***X*X*****X*X*X*********X*X*X*****X***************
*XXX*XXXXX*XXX*XXX*XXXXXXXXX*X*X*X*XXX*X*XXX*XXXXXX
*X*X*X*X*X*X***X***************X*X*X*X*X***X*X***X*
*X*XXX*X*X*XXX*XXX*XXXXXXXXX*XXXXX*X*XXXXXXX*X*XXX*
***X***************X***X*X*X***X*X*X*X*****X*******
XX*XXXXX*XXXXX*XXXXX*XXX*X*XXX*X*XXX*X*XXX*X*X*X*XX
*****X*****X*****X*X***X*****X***********X*X*X*X*X*
*X*XXXXX*XXXXX*XXX*X*XXX*XXX*X*X*X*X*XXXXXXXXXXX*X*
*X***X*****X*X*********X*X*X*X*X*X*X***********X***
*X*XXX*X*X*X*XXX*XXXXX*X*X*XXX*XXXXXXXXX*XXXXXXXXX*
*X*X***X*X*X***X***X*X*****X*X*********X***X*X***X*
*XXX*X*X*X*XXX*X*X*X*X*X*X*X*XXX*XXX*XXXXXXX*XXX*X*
*X***X*X*X*X*****X*X***X*X*****X***X***X*********X*
*XXX*X*X*X*XXXXX*XXXXX*XXXXXXX*XXXXX*XXXXX*XXX*X*XX
*X***X*X*X***X***X*X*X***X***X***X*********X***X***
*XXX*XXX*X*XXXXX*X*X*X*XXX*XXX*XXX*X*XXXXXXXXX*XXX*
*X***X***X*****X*****X*****X*X***X*X*****X***X*X*X*
*X*XXXXX*X*X*XXX*X*XXXXX*X*X*XXXXXXX*XXXXX*XXX*X*X*
*X*X*****X*X*X***X***X***X*****X*************X***XX