***XXXXXXXXXXXXXXXXXXXXXXXXXXXXXXXXXXXXXXXXXXXXXXXXXXXXXXXXXXXXXXXXXXXXXXXXXXXXXXXXXXXXXXXXXXXXXXXXX
X*X***X*********X*****X*X*******X*X*X*X*X***X*X***X*****X*****X*X*X*X*X***X*********X***X*X*X*****X*
X*XXX*XXXXX*XXXXXXX*XXX*XXXXXXX*X*X*X*X*X*XXX*X*XXX*XXXXXXX*XXX*X*X*X*XXX*XXXXXXX*XXX*XXX*X*X*XXXXX*
X*******X*X*********X*X*X*X***X*****X*******X*********X*X***X***X***X***X*X*******X***************X*
X*X*XXX*X*XXX*XXXXX*X*X*X*XXX*XXX*XXXXXXX*XXX*XXXXX*X*X*XXX*X*XXX*XXX*XXX*XXX*XXX*X*XXXXX*X*XXX*XXX*
X*X*X*****X*X*X*X*****X*X*X*X*X*******X*X*X*X*****X*X*X*********X*****X*****X*X*X*******X*X***X***X*
X*XXX*XXX*X*XXX*X*X*XXX*X*X*X*XXX*XXXXX*X*X*X*XXXXXXXXX*XXXXXXXXX*XXXXXXX*XXXXX*X*XXXXX*XXX*XXXXXXX*
X*X***X*********X*X***X*X*X***X***X*X*X*****X*******X*X***X*X*****X*****X***X***X*****X***X***X*****
X*XXXXXXXXXXXXX*XXXXX*X*X*X*XXX*XXX*X*XXX*XXX*XXXXXXX*X*XXX*XXX*XXX*XXXXX*XXX*XXX*XXXXX*XXXXXXXXX*X*
X*X***X*X*X*X*X***X*************X*X*X***X*X*******X***X***X***X*X*X***X*********X***X*********X***X*
XXX*XXX*X*X*X*X*XXXXXXX*XXXXXXX*X*X*X*XXX*XXX*XXXXX*XXXXX*X*XXX*X*X*XXXXX*XXXXXXX*X*XXXXX*XXXXXXX*XX
X***X*X*X*X*X*****X*****X***X***X*****X*****X*X*X*X***X*X*****X***X***************X***X*X***X*X*****
XXX*X*X*X*X*XXXXX*XXX*XXX*XXX*X*XXXXX*XXX*XXX*X*X*X*XXX*XXX*XXX*XXXXX*X*XXXXX*XXXXXXXXX*XXXXX*X*X*XX
X*X*X*************X*X*X***X*X*X***X*************X***X***X***X*X*X*X*X*X*X*X*X*X*X*******X*******X***
X*X*XXXXXXX*XXXXX*X*XXXXX*X*XXXXX*X*X*XXX*XXX*XXX*XXXXX*XXX*X*X*X*X*X*XXX*X*XXX*X*XXX*X*X*XXXXXXX*X*
X***X*******X*X*****X*X*X*X***X***X*X***X***X*X*X*****X*************X*X*X***X*******X*X*X*X*X***X*X*
XXX*XXXXXXXXX*XXX*X*X*X*X*XXX*X*XXXXX*XXXXX*XXX*X*XXXXX*XXXXX*XXXXXXX*X*XXX*X*XXX*X*XXXXX*X*X*XXX*XX
X*X***X*X*********X***************X*X***X***X*****X*X*****X*X*******X***********X*X*X*X*********X*X*
X*X*XXX*X*XXX*XXXXXXX*XXXXX*X*XXX*X*X*XXXXX*XXX*XXX*XXX*XXX*X*X*XXXXXXX*XXX*XXXXXXXXX*XXX*X*XXXXXXX*
X*X***X*X*X***X***X***X*X***X*X*********X*X*X*X***X***X*****X*X*********X*****X*X*X***X*X*X*X*X*X*X*
X*X*XXX*XXXXX*X*XXXXXXX*XXXXXXXXX*XXX*XXX*XXX*X*XXX*XXX*X*XXX*XXX*XXXXX*XXXXXXX*X*X*XXX*X*XXX*X*X*X*
X***X*******X*X***X*****X***X*X***X*X*X*****X*X*X*X*X***X*X*X*X*X*****X*X*******X***********X*******
X*XXX*X*X*X*XXX*X*XXX*XXXXX*X*XXXXX*X*X*XXXXX*X*X*X*X*XXXXX*XXX*XXX*X*XXXXX*XXX*X*XXXXXXXXXXX*XXX*XX
X*X***X*X*X***X*X***X*X***X***************X*X*X*******X*X*********X*X*********X*X***X*X***X*X*X*X*X*
X*XXXXXXXXX*X*X*XXXXX*X*XXXXXXXXXXXXX*XXXXX*X*X*XXX*XXX*X*XXXXX*X*XXX*X*XXX*XXXXX*XXX*XXX*X*X*X*X*X*
X*****X*****X***X***X***X*****X*X*X*****X*X*******X***X***X*X*X*X***X*X***X***********X*********X***
XXX*XXXXXXX*XXX*X*XXXXX*XXX*XXX*X*X*X*XXX*X*XXXXXXX*XXX*XXX*X*XXXXXXXXX*X*XXX*X*XXX*XXX*XXXXX*X*X*X*
X***X*X*****X***X*********X***X***X*X*****X*X***X*********************X*X*X*X*X***X*******X***X*X*X*
XXX*X*XXXXXXXXX*X*XXXXX*XXX*X*XXX*XXX*XXXXX*XXX*XXXXXXXXXXXXXXX*XXXXXXXXXXX*XXX*XXX*XXXXX*XXX*XXXXXX
X*********X*****X*X***X***X*X*X***********************X*X*****X*X*X*****X***X*X***X***X***X*X***X*X*
XXXXXXX*XXXXXXX*XXXXX*XXX*XXX*XXX*X*X*XXX*X*X*XXX*XXX*X*X*X*XXXXX*XXX*XXX*XXX*X*XXXXXXXXXXX*XXXXX*X*
X***X*X***X*********X*************X*X***X*X*X***X*X*******X***X***X*********X***X***X*****X*X*X*****
XXX*X*X*XXX*XXX*XXX*XXX*X*X*X*XXXXXXX*XXX*XXXXXXX*X*XXXXXXXXXXX*XXX*XXXXXXXXXXXXXXX*XXX*XXX*X*X*XXXX
X*****X*X*****X*X*******X*X*X***X*****X*X*X*****X*X*X***X***X*X*****X*X*X*X*X***X*X*X*****X*****X*X*
XXX*X*X*XXX*XXXXX*X*X*X*X*XXXXXXX*X*X*X*X*X*XXX*XXXXX*XXX*XXX*X*XXXXX*X*X*X*XXX*X*X*XXX*XXX*X*X*X*X*
X***X***X*X*X*X*X*X*X*X*X***X*****X*X***X***X*******X***********X***************************X*X*****
XXXXXXX*X*XXX*X*XXX*XXXXX*XXXXXXXXXXXXX*XXX*XXX*X*XXX*XXX*X*XXXXXXXXX*X*XXXXXXXXXXX*X*X*X*X*X*X*X*XX
X*********************X***X*X*X***********X***X*X*****X***X***********X*********X***X*X*X*X*X*X*X***
XXX*X*X*XXXXX*XXX*XXXXXXX*X*X*XXX*XXX*XXX*XXX*X*X*X*X*XXX*XXX*X*X*XXX*XXXXXXXXXXXXXXXXXXXXXXXXXXXXXX
X***X*X***X***X*****X*****X*******X***X*****X*X*X*X*X*X*X***X*X*X***X*****X***X*X***X***********X***
X*X*XXX*XXXXX*X*X*X*X*X*XXX*X*XXX*XXXXXXX*XXX*XXXXXXX*X*XXX*XXX*XXX*X*XXX*XXX*X*XXX*X*X*XXXXXXXXX*XX
X*X***X*****X*X*X*X*X*X*X***X*X*******X***X*****X*****X*X*X*X***X***X***X*******X***X*X*X***********
XXXXXXX*XXXXX*XXXXX*XXXXX*X*XXXXXXX*XXX*X*XXX*XXXXX*X*X*X*XXXXX*XXX*X*X*X*XXX*X*X*XXXXX*XXX*XXX*XXX*
X***X*****X*X*X*******X***X***X*****X***X***X*****X*X*********X***X*X*X*X***X*X*****X*****X***X***X*
X*XXX*XXXXX*XXX*XXX*X*X*XXX*XXX*X*XXXXX*XXX*X*X*X*XXX*X*X*X*XXXXXXXXXXXXX*X*XXXXXXXXXXXXX*X*XXXXXXXX
X*****X***X*******X*X*X*X*****X*X***X***X***X*X*X***X*X*X*X*********X*X*X*X***********X*************
X*XXX*XXX*X*XXX*XXX*XXX*XXX*XXX*XXX*XXX*XXX*X*X*XXX*X*X*XXX*XXXXXXXXX*X*XXX*X*X*XXXXXXXXX*XXX*XXXXXX
X*X*X*X*****X*****X*X***X*****X***X*X***X***X*X*X*X*X*X*X*X*X*X*X*X*******X*X*X*******X***X*********
X*X*X*X*X*X*X*X*XXXXXXXXXXXXXXX*XXX*XXX*XXX*X*XXX*X*XXX*X*X*X*X*X*X*XXX*XXX*XXX*XXXXXXX*XXXXXXX*XXXX
X*X***X*X*X*X*X*****X***********X***X***X***X***X***X***X*************X*X*****X*************X*******