***************XXX
*X*X*XX*X*XX*XXXX*
*X*X*X*X*XX*X*X*XX
*X*XX*XXXXX*X*X*X*
*X*X*X*X*XX*X*X*X*
*X*****X*XX*X*XX*X
*XXXXX*X*X*X*X*X*X
*XXX*X*XXXXX*X*XXX
*X*X*X***XX*X*X*X*
*XX***X*XX*X*X*XX*
*X*X*XX***X*XX*X**
*XXX*X*X*X*X*XXX*X
*XXX*XXX*X*XXX*X*X
******************